1000000000000000000002222222288822222222200000000000000000000022200000000002220000000000000022200000000000000000000000000000222200000000000000000000000000000000000000000000000000000000000000000002222
1000000000000000220021111888888111111111000000000000000000000000000000000000012222220222222210000000000000000000000000000000111100000000000000000000000000000333000000000000000000000000000333000001111
1000000000022000000011118888881111111110000000000000000000000000000000000000000000000000000000000000000000000000000000000000111100000000000000000000000000000000000000000000000000000000000000000001111
1000000000000000000001188888111111111000000000000000000000000000000000000000000000000000000000000000000000000000000000000000111100000000000000000000000000000000000000000000000000000000000000000001111
1000022000000000000001888881111111100000000222220000000000000000000020200000000000002002222220000000000000000000000000000001111000000000000000000000000000000000000000000000000033300000000000000001111
1000000000000000055551888811111100000000000000000000000000000000000000000000000000000000000000000000000000000000000000000000211000000000000000000000000000000000000000000000000000000000000000000001111
1000000000000000555555888111111000000000000000000000000000000000000000000000000000000000000000000000000000000000000000000002100000000000000000000000000000000000000000000000000000000000000000000001111
1222000000000005544445511111100000000000000000000000000020000000000020200000000000000000000000000000000000000000000000000021000000000000333000000000000000000000000000000000000000000000000000000001111
1111200000000000455554111111100000000000000000000000000000000000000000000000000000000000000000000000000000000000000000000210000000000000000000000000000000000000000000000000000000000000000000000001111
1111100000000000556654111110000000000000000000000000000000000000000000000000000000000002222222220000000000000000000000002100000000000000000000000000000000000000000000000000000000000005555555555501111
1111190000000900555574111100000000000000000000000000000000000022222200022222000000000021111111112000000000000000222222221000000000000000000000000000000000000000000000000000000000000054444444444451111
1111122200022222444444111000000000000000000000000000000000000000000000000000000000000013333333331000000000000002111111110000000000000000000000000000000000000000000000000000000000000045555555555541111
1111111000011111111111100000000000000000000000000000000000000000000000000000000000000003333333330000000000000000000000000000000000000000000000000000000000000000000000000000000000000045566555665541111
1111111000001111111111000000000000000000000000000000000000000000000000000000000000000000000000000000000000000000000000000000000000000000000000000003330000000000000000000000000000000055555555555541111
1111133000000111111110000000000000000000000000000000000000000000000000000000000000000000000000000000200020002003333333330000000000000000000000000000000000000000000000000000000000000055555555555541111
1113330000000000000000000022222000000000000000000000000000000000000000000000000000000000000000000000000000000000033333333000000000000000000000000000000000000000000000000004004000044444444444444441111
1133339000000000000000002211111220000000000000000000000000000000000000000000000000000000000000000000000000000000000333333000000000000000000000000000000000000000000000000000000000222222222222222221111
1333333330000000000000031111111112200002220000000000000002200022222222200022000000000000000000000000000000000000000003333000000000000000000000000000000000000000000000000000000000011111111111111113333
1333333333313333333333333333331000000021112000000000002001100211111111120011000000000000000000000000000000000000000000033000000000000000000000000000000000000000000000000000000000003333333333333333333
1333333311111333333111333333300000000013331000022200021001100133333333310033000000000000000000000000000000000000000000033000000333000000000000000000000000000000000000000000000000003333333333333333333
3333330000000000000000883333300000000033333000211120033003300333333333330000000000000000000000000000000000000000000000033300000000000000000000000000000000000000003330000000000000000033333333333333333
3333330000000000000000883333333333000033333000133310033003300033333333300000000000000000000000000000000000000000000000033300000000000000000000000000000000000000000000000000000000000000033333333333333
3333333333333333333333883333313333000033333000333330000000000000000000000000000000000000000000000000000000000000000000033300000000000000000000000000000000000000000000000000000000000000000000333333333
3333333333333333333333888333113333000033333000033300000000000000000000000000000000000000000000000000000000000000000000033300000000000000000000000000000000000000000000000000000000000000000000000033333
3331111333333333333338883333333333000033333000003000000000000033333333300000000000000000000000000000000000000000000000033300000000000000000000000000000333000000000000000000000000000000000000000033333
3333313333333333333333888333333333000033333000000000000000000333333333330000000000000000000000000000000000000000000000033300000000000000000000000000000000000000000000000000000000000000000000000033333
3333333333333333333333388333333330000003330000000000000000000333333333330000000000000000000000000000000000000000000000033300000000000000000000000000000000000000000000000000000000000000000000000033333
3333333333333333333333388333333000000000300000000000000000000333333333330000020000200000000000000000000000000000000000033300000000000000000000000000000000000000000000000000000000000000000000000033333
3333333333333333333333388000000000000000000000000000000000000033333333300000010000100000000000000000000000000000000000033300000000000000000000000000000000000000000000000000000000000000000000000033333
3333333333333333333330000000000000000000000000000000000000000003333333000000000000000002220000000000000000000000000000033330000000000000000000000000000000000000000000000000000000333000000000000033333
3333333333333333333333000000000000000000000000000000000000000000333333000000000000000001110000000000000000000000000000033330000000000000000000000000000000000000000000000000000000000000000000000033333
3333333333333333333333333330000000000000000000000000000000000000003330000000000000000000000000000000000000000000000000033330000000000000000000000000000000000000000000000000000000000000000000000033333
3333333333333333333300000000000000000000000000000000000000000000000000000000000000000000000000000000000000000000000000033333000000000000000000000000000000000000000000000000000000000000000000000033333
3333333333333333333000000000000000000000000000000000000000000000000000000000000000000000000000000000000000000000000000033333300000000000000000000000000000000000000000000000000000000000000000000003333



