1000000000000000000002222222288822222222200
1000000000000000220021111888888111111111000
1000000000022000000011118888881111111110000
1000000000000000000001188888111111111000000
1000022000000000000001888881111111100000000
1000000000000000055551888811111100000000000
1000000000000000555555888111111000000000000
1222000000000005544445511111100000000000000
1111200000000000455554111111100000000000000
1111100000000000556654111110000000000000000
1111190000000900555574111100000000000000000
1111122200022222444444111000000000000000000
1111111000011111111111100000000000000000000
1111111000001111111111000000000000000000000
1111133000000111111110000000000000000000000
1113330000000000000000000022222000000000000
1133339000000000000000002211111220000000000
1333333330000000000000031111111112200002220
1333333333313333333333333333331110000021112
1333333311111333333111333333300000000013331
3333333333111133331111333333300000000033333
3333333333333333333311333333333333000033333
3333333333333333333333333333333333000033333
3333333333333333333333333333333333000033333
3333333333333333333333333333333333000033333
3333333333333333333333333333333333000033333
