100000000000000000000222222228882222222220000000000000000000000220000000000222222200000000000000000000000000000000000000000000000000000000000000000000000000000000000000000000000000000000000000000
100000000000000022002111188888811111111100000000000000000000000000000000000000000000000000000000000000000000000000000000000000000000000000000000000000000000000000000000000000000000000000000000000
100000000002200000001111888888111111111000000000000000000000000000000000000000000000000000000000000000000000000000000000000000000000000000000000000000000000000000000000000000000000000000000000000
100000000000000000000118888811111111100000000000000000000000000000000000000000000000000000000000000000000000000000000000000000000000000000000000000000000000000000000000000000000000000000000000000
100002200000000000000188888111111110000000022222000000000000000000002020000000000000000000000000000000000000000000000000000000000000000000000000000000000000000000000000000000000000000000000000000
100000000000000005555188881111110000000000000000000000000000000000000000000000000000000000000000000000000000000000000000000000000000000000000000000000000000000000000000000000000000000000000000000
100000000000000055555588811111100000000000000000000000000000000000000000000000000000000000000000000000000000000000000000000000000000000000000000000000000000000000000000000000000000000000000000000
122200000000000554444551111110000000000000000000000000000220000000002020000000000000000000000000000000000000000000000000000000000000000000000000000000000000000000000000000000000000000000000000000
111120000000000045555411111110000000000000000000000000000000000000000000000000000000000000000000000000000000000000000000000000000000000000000000000000000000000000000000000000000000000000000000000
111110000000000055665411111000000000000000000000000000000000000000000000000000000000000222222222000000000000000000000000000000000000000000000000000000000000000000000000000000000000000000000000000
111119000000090055557411110000000000000000000000000000000000002222220002222200000000002111111111000000000000000000000000000000000000000000000000000000000000000000000000000000000000000000000000000
111112220002222244444411100000000000000000000000000000000000000000000000000000000000001333333333000000000000000000000000000000000000000000000000000000000000000000000000000000000000000000000000000
111111100001111111111110000000000000000000000000000000000000000000000000000000000000000000000000000000000000000000000000000000000000000000000000000000000000000000000000000000000000000000000000000
111111100000111111111100000000000000000000000000000000000000000000000000000000000000000000000000000000000000000000000000000000000000000000000000000000000000000000000000000000000000000000000000000
111113300000011111111000000000000000000000000000000000000000000000000000000000000000000000000000000000000000000000000000000000000000000000000000000000000000000000000000000000000000000000000000000
111333000000000000000000002222200000000000000000000000000000000000000000000000000000000000000000000000000000000000000000000000000000000000000000000000000000000000000000000000000000000000000000000
113333900000000000000000221111122000000000000000000000000000000000000000000000000000000000000000000000000000000000000000000000000000000000000000000000000000000000000000000000000000000000000000000
133333333000000000000003111111111220000222000000000000000220002222222220002200000000000000000000000000000000000000000000000000000000000000000000000000000000000000000000000000000000000000000000000
133333333331333333333333333333100000002111200000000000200110021111111112001100000000000000000000000000000000000000000000000000000000000000000000000000000000000000000000000000000000000000000000000
133333331111133333311133333330000000001333100002220002100110013333333331003300000000000000000000000000000000000000000000000000000000000000000000000000000000000000000000000000000000000000000000000
333333000000000000001133333330000000003333300021112003300330033333333333000000000000000000000000000000000000000000000000000000000000000000000000000000000000000000000000000000000000000000000000000
333333000000000000000033333333333300003333300013331003300330003333333330000000000000000000000000000000000000000000000000000000000000000000000000000000000000000000000000000000000000000000000000000
333333333333333333333333333333333300003333300033333000000000000000000000000000000000000000000000000000000000000000000000000000000000000000000000000000000000000000000000000000000000000000000000000
333333333333333333333333333333333300003333300003330000000000000000000000000000000000000000000000000000000000000000000000000000000000000000000000000000000000000000000000000000000000000000000000000
333333333333333333333333333333333300003333300000300000000000003333333330000000000000000000000000000000000000000000000000000000000000000000000000000000000000000000000000000000000000000000000000000
333333333333333333333333333333333300003333300000000000000000033333333333000000000000000000000000000000000000000000000000000000000000000000000000000000000000000000000000000000000000000000000000000
333333333333333333333333333333333000000333000000000000000000033333333333000000000000000000000000000000000000000000000000000000000000000000000000000000000000000000000000000000000000000000000000000
333333333333333333333333333333300000000030000000000000000000033333333333000000000000000000000000000000000000000000000000000000000000000000000000000000000000000000000000000000000000000000000000000
333333333333333333333333333333000000000000000000000000000000003333333330000000000000000000000000000000000000000000000000000000000000000000000000000000000000000000000000000000000000000000000000000
333333333333333333333333333333000000000000000000000000000000000333333300000000000000000000000000000000000000000000000000000000000000000000000000000000000000000000000000000000000000000000000000000
333333333333333333333333333300000000000000000000000000000000000033333300000000000000000000000000000000000000000000000000000000000000000000000000000000000000000000000000000000000000000000000000000
333333333333333333333333333000000000000000000000000000000000000000333000000000000000000000000000000000000000000000000000000000000000000000000000000000000000000000000000000000000000000000000000000
333333333333333333330000000000000000000000000000000000000000000000000000000000000000000000000000000000000000000000000000000000000000000000000000000000000000000000000000000000000000000000000000000




S