000000000000000000000000000000000000
000000000000000000000000000000000000
000000000000000000000000000000000000
000000000200000000000000000000000000
000000022220000000000000000000000000
000000222222000000000000000000000000
000000000000000000022222000000000000
200000000000000002211111220000000000
120000000000000021111111112200002220
112222222222222211133330000000021112
311111111111111111333300000000013331
333333333333333333333300000000033333
333333333333333333333333333000033333
333333333333333333333333333000033333
333333333333333333333333333000033333
333333333333333333333333333000033333
333333333333333333333333333000033333
333333333311111133333333300000011111
333333333333111113333333100000033333
333333333331111133333333330000003333 